6 15 1 4
0 0 0 0 0 0 1 1 1 1 0 0 1 1 1
1 1 1 1 0 0 1 1 3 1 0 0 1 9 1
1 1 5 1 0 0 1 1 1 1 0 0 1 1 1
1 1 1 1 0 0 1 1 1 1 0 0 1 1 1
1 1 1 1 0 0 1 1 1 1 0 0 1 1 1
1 1 1 1 0 0 1 1 1 1 0 0 1 1 1
8 1 2 10 5 11 5
2 2 2 4 5 5 5