6 10 2 2
1 1 1 0 0 0 0 0 0 0
1 1 1 1 1 1 0 0 0 0
1 1 1 1 1 1 1 1 1 0
0 1 1 1 1 1 1 1 1 1
0 0 0 0 0 1 1 9 1 1
0 0 0 0 0 0 1 1 1 0


1 1 1 0 0 0 0 0 0 0
1 1 1 4 3 3 0 0 0 0
1 1 1 4 3 2 2 2 2 0
0 1 1 4 3 2 1 1 1 2
0 0 0 0 3 2 1 0 1 2
0 0 0 0 0 0 1 1 1 0



vs a[5][]